// Use http://centricle.com/tools/ascii-hex/ for hex codes
urlHelp=help/index.html
lastSaved=Last Saved
currentFile=Current File
toolbar=工具栏
save=保存
print=打印
cut=剪切
copy=复制
paste=粘贴
delete=删除
undo=撤消
redo=重做
select=Select
connect=Connect
pan=Pan
zoomIn=Zoom In
zoomOut=Zoom Out
zoom=大小
fit=适合大小
actualSize=Actual Size
selectAll=Select All
clearSelection=Clear Selection
shape=Shape
format=格式
font=Font
group=分组
ungroup=取消分组
removeFromParent=Orphan
align=对齐
left=Left
right=Right
center=Center
top=Top
middle=Middle
bottom=Bottom
collapse=Collapse
expand=Expand
toBack=Send to back
toFront=Bring to front
enterGroup=Enter group
exitGroup=Exit group
layout=Layout
horizontalTree=Horizontal Tree
verticalTree=Vertical Tree
fillColor=填充颜色
strokeColor=线颜色
gradientColor=Gradient Color
bold=粗体
italic=斜体
fontColor=字体颜色
fontSize=Font Size
fontFamily=Font Family
examples=Examples
newDiagram=New Diagram
image=Image
opacity=Opacity
selection=Selection
editStyle=Edit Style
enterStyle=Enter Style
enterColorname=Enter Colorname
enterImageUrl=Enter Image URL
enterOpacity=Enter Opacity (%)
enterFontsize=Enter Fontsize (pt)
enterFontfamily=Enter Fontfamily
toggleRounded=Rounded
toggleShadow=Shadow
openHref=Open URL
show=显示
exportImage=Export Image
exportSvg=Export SVG
changesLost=All changes will be lost!
swimlanes=Swimlanes
travelBooking=Travel Booking
notAvailable=Not available
